NO textures/north_wall.xpm
SO textures/south_wall.xpm
WE textures/west_wall.xpm
EA textures/east_wall.xpm

F 220,100,0
C 225,30,0


111111111111111
100000000010001
100100000010001
100000000010001
100001000010001
100000000000001
100000000100001
100010S00000001
100000000000001
111111111111111
