NO textures/north_wall.xpm



		EA               textures/east_wall.xpm



                               SO textures/south_wall.xpm

C 		    225,	 30,	 0



WE 			textures/west_wall.xpm


F 220,100,0


1111
10S1
1011
11110
1111
1
1
1
