NO textures/Bricks_04_Red_3_2.xpm



		EA               textures/Concrete_02_Orange_HorLines_1.xpm



                               SO textures/Tiles_Circle_01_Red_1.xpm

C 		    225,	 30,	 0

WE 			textures/Wallpaper_01_Red_1.xpm


F 220,100,0






        1111111111011111111111111
        1000000000110000000000001
        1011000001010000000000001
        10010000000000000000000011
11111111101100000111000000000000001
1000000000110000011101111111111111
11110111111111011100000010001
11110111111111011101010010001
11000000110101011100000010001
10000000000000001100000000001
10000000000000001101010010001
10000001110101011111011110N01
10110111 1110101 101111010001
10111111 1111111 111111111110
101
101
101
101
101
101
101
101
101
111
